000000000000000000000000000000000000000000000000000000000000000000000000000000000000000000000000000000000000000000000000000000000000000000000000000000000000000000000
000000000000000000000000000000000000000000000000000000000000000000000000000000000000000000000000000000000000000000000000000000000000000000000000000000000000000000000
000000000000000000000000000000000000000000000000000000000000000000000000000000000000000000000000000000000000000000000000000000000000000000000000000000000000000000000
000000000000000000000000000000000000000000000000000000000000000000000000000000000000000000000000000000000000000000000000000000000000000000000000000000000000000000000
000000000000000000000000000000000000000000000000000000000000000000000000000000000000000000000*000000@0000000000000000000000000000000000000000000000000000000000000000
000000000000000000000000000000000000000000000000000000000000000000000000000000000000000000002220000220000000000000000000000000000000000000000000000000000000000000000
0000000000005000000000000000000000000000000000000000000000000000000000000000000000000+0000000000000000000000000000000000000000000000000000000000000000000000500000000
000000000000500000000000000000000000000000000000000000000000220000000000000000000000011000000000000000011000000000000000000000000000000000000000000000000000500000000
0000000000005000000000000000000000022000000000000000000#000000000&000000000000000000033000000000000000033100000000000000000000000000000000000000000000000000500000000
000000000000500000000000000*00000000000000@00000000000220000000002200000000000000000133500000000000000033311000000000000000000000000000000000000000000000000500000000
000000000000500000000000000220000000000000220000011000000000000000000000000000000000333000000000000000033333110000000000000000000000000000000000000000000000500000000
000000000000500000+000000000000000000000000000001330000000000000000000002000000000013330000000000000000333333300#000004400&00004440000000000000000$000000000500000000
111111111111111111100000000000000000000000000001333000000000000000000000000000111113333111111111111111133333331111111111111111111111111111111111111111111111111111111
333333333333333333311111144411111111114444111443333444444444444444444444444444333333333333333333333333333333333333333333333333333333333333333333333333333333333333333
333333333333333333333333333333333333333333333333333333333333333333333333333333333333333333333333333333333333333333333333333333333333333333333333333333333333333333333
333333333333333333333333333333333333333333333333333333333333333333333333333333333333333333333333333333333333333333333333333333333333333333333333333333333333333333333
333333333333333333333333333333333333333333333333333333333333333333333333333333333333333333333333333333333333333333333333333333333333333333333333333333333333333333333
333333333333333333333333333333333333333333333333333333333333333333333333333333333333333333333333333333333333333333333333333333333333333333333333333333333333333333333