00000000000000000000000000000000000000000000000000000000000000000000000000000000000000000000000000000000000000000000000000000000000000000000000000000000000000000000000000000000000000000000000000000000000000000000000000000000000000000000000000000
00000000000000000000000000000000000000000000000000000000000000000000000000000000000000000000000000000000000000000000000000000000000000000000000000000000000000000000000000000000000000000000000000000000000000000000000000000000000000000000000000000
00000000000000000000000000000000000000000000000000000000000000000000000000000000000000000000000000000000000000000000000000000000000000000000000000000000000000000000000000000000000000000000000000000000000000000000000000000000000000000000000000000
00000000000000000000000000000000000000000000000000000000000000000000000000000000000000000000000000000000000000000000000000000000000000000000000000000000000000000000000000000000000000000000000000000000000000000000000000000000000000000000000000000
00000000000000005000000000000000000000000000000000000000000000000000000000000000000000000000000000000000000000000000000000000000000000000000000000000000000000000000000000000000000000000000000000000000000000000000000000000000000000000000000000000
00000000000000005000000000000000000000000000000000000000000000000000000000000000000000000000000000000000000000000000000000000000000000000000000000000000*00000000000000000000000000000000000000000000000000000000000000000000000000000000000000000000
0000000000000000500000000000000000000000000000000000000000000000000000000000000000000000000000000000000000000000000000000000000000000000000000000000000000000+000000000000000000000000000000000000000000000000000000000000000000000000000000000000000
000000000000000050000000000000000000000000000000000*00000000000000000000000000000000000000000000000260000000#0000000000000000000000000000000026000026000026000026000000000000000000000000000000000000000000000000000000000000000000000500000000000000
000000000000000050000000000000+000000000000000000026000000000000000000000000000000000000000000000000000000002600000000000000000000000000000000000000000000000000000000000000000000000000000@000000000000000000000000000000000000000000500000000000000
00000000000000005000000000000026000000000000260000000000026000000000000000000000000000000000260000000000000000000002600000000000000000000000000000000000000000000000000000000000000000000000000000000000000*00000000000000000000000050000000000000000
000000000000000050000000000000000000026000000000000000000000000000@000000000000000000000000000000000000000000000000000000000000000000010000000000000000000000000000260000000#000000000000000002600000000000000000000000000000000005000000000000000000
111111111111111111111111110000000000000000000000000000000000000002600000000000000000000000000000000444400000000000000000000000000000001300000000000000000000000000000000000000000000000000000000000#000004400000000000000000$000000050000000000000000
33333333333333333333333333000000000000000000000000000000000000000000000011111111111111111111111111111111111111111111111111111111111111111111111111111111111111111111111111111111111000001110000000001111111111111111111111111111111111111111111111111
33333333333333333333333333444444444444444444444444444444444444444444444433333333333333333333333333333333333333333333333333333333333333333333333333333333333333333333333333333333333444443334444444443333333333333333333333333333333333333333333333333
33333333333333333333333333333333333333333333333333333333333333333333333333333333333333333333333333333333333333333333333333333333333333333333333333333333333333333333333333333333333333333333333333333333333333333333333333333333333333333333333333333
33333333333333333333333333333333333333333333333333333333333333333333333333333333333333333333333333333333333333333333333333333333333333333333333333333333333333333333333333333333333333333333333333333333333333333333333333333333333333333333333333333
33333333333333333333333333333333333333333333333333333333333333333333333333333333333333333333333333333333333333333333333333333333333333333333333333333333333333333333333333333333333333333333333333333333333333333333333333333333333333333333333333333
33333333333333333333333333333333333333333333333333333333333333333333333333333333333333333333333333333333333333333333333333333333333333333333333333333333333333333333333333333333333333333333333333333333333333333333333333333333333333333333333333333